year,Australia,India,West Indies,Pakistan,Sri Lanka,England,New Zealand,South Africa,Bangladesh,Afghanistan
1975,0,0,1,0,0,0,0,0,0,0
1979,0,0,2,0,0,0,0,0,0,0
1983,0,1,2,0,0,0,0,0,0,0
1987,1,1,2,0,0,0,0,0,0,0
1992,1,1,2,1,0,0,0,0,0,0
1996,1,1,2,1,1,0,0,0,0,0
1999,2,1,2,1,1,0,0,0,0,0
2003,3,1,2,1,1,0,0,0,0,0
2007,4,1,2,1,1,0,0,0,0,0
2011,4,2,2,1,1,0,0,0,0,0
2015,5,2,2,1,1,0,0,0,0,0
2019,5,2,2,1,1,1,0,0,0,0
2023,5,2,2,1,1,1,0,0,0,0
