year,South Africa,New Zealand,Australia,England,France,Wales,Ireland,Scotland,Argentina,Japan
1987,0,1,0,0,0,0,0,0,0,0
1991,0,1,1,0,0,0,0,0,0,0
1995,1,1,1,0,0,0,0,0,0,0
1999,1,1,2,0,0,0,0,0,0,0
2003,1,1,2,1,0,0,0,0,0,0
2007,2,1,2,1,0,0,0,0,0,0
2011,2,2,2,1,0,0,0,0,0,0
2015,2,3,2,1,0,0,0,0,0,0
2019,3,3,2,1,0,0,0,0,0,0
2023,4,3,2,1,0,0,0,0,0,0
